NO ../textures/NO.png
SO ../textures/SO.png
WE ../textures/WE.png
EA ../textures/EA.png

F 255,255,0
C 255,255,0

1111111111
1000000j01
1000N00001
1000000001
1111111111
