
NO ./textures/wall_N.png
SO ./textures/wall_S.png
WE ./textures/wall_W.png
EA ./textures/wall_E.png


F 255,255,0
C 255,255,0

1111111111           11111111111111111
1000000001           10000000000000001
100000000111         10000000000011111
1000000000001        10000N0000001
1111111000001111111111000000000001
      100000000000000000000000000111
      100000011111100000000000000001
      1110000001   1100000000000111111
     11000000111    1000000000001
11111000000111      1111111110001
100000001111               10011
101111111  11111          1101
111        10001           101
101111      11101           11
1111101      1101            1
1001 1      10111           101
1001        10001           101
10011111111110111           101
100000000000001             101
1111111111111011111111111111101
            1000000000000000001
            1111111111111111111
