NO ../textures/NO.png
SO ../textures/SO.png
WE ../textures/WE.png
EA ../textures/EA.png\n
\n
       \n
F 255,255,0
C 255,255,0

1111111111           11111111111111111
1000000001           10000000000000001
1000N00001           10000000000011111
1000000001           1000000000001
1111111001111111111111000000000001
      100000000000000000000000000111
	  100000011111100000000000000001
	1110000001    100000000000111111
	1000000111    1000000000001
111110000001      1111111111001
100000001111               1001
101111111   11111          1101
111         10001           101
            10111           101
1111		101			    101
1001        10111           101
1001        10001           101
10011111111110111           101
100000000000001             101
1111111111111011111111111111101
            1000000000000000001
			1111111111111111111
         \n
EOF