NO ./textures/wall_N.png
SO ./textures/wall_S.png
WE ./textures/wall_W.png
EA ./textures/wall_E.png

F 255,255,0
C 0,255,0

1111111111
1000000001
1000N00001
1000000001
1111111111
